00000000000000000000000000000000000000000000000000000000000000000000000000000000000000000000000
00000000000000000000000000000000000000000000000000000000000000000000000000000000000000000000000
00000000000000000000000000000000000000000000000000000000000000000000000000000000000000000000000
00000000000000000000000000000000000000000000000000000000000000000000000000000000000000000000000
00000000000000000000000000000000000000000000000000000000000000000000000000000000000000000000000
00000000000000000000000000000000000000000000000000000000000000000000000000000000000000000000000
00000000000000000000000000000000000000000000000000000000000000000000000000000000000000000000000
00000000000000000000000000000000000000000000000000000000000000000000000000000000000000000000000
00000000000000000000000000000000000000000000000000000000000000000000000000000000000000000000000
00000000000000000000000000000000000000000000000000000000000000000000000000000000000000000000000
00000000000000000000000000000000000000000000000000000000000000000000000000000000000000000000000
00000000000000000000000000000000000000000000000000000000000000000000000000000000000000000000000
00000000000000000000000000000000000000000000000000000000000000000000000000000000000000000000000
00000000000000000000000000000000000000000000000000000000000000000000000000000000000000000000000
00000000000000000000000000000000000000000000000000000000000000000000000000000000000000000000000
00000000000000000000000000000000000000000000000000000000000000000000000000000000000000000000000
00000000000000000000000000000000000000000000000000000000000000000000000000000000000000000000000
00000000000000000000000000000000000000000000000000000000000000000000000000000000000000000000000
00000000000000000000000000000000000000000000000000000000000000000000000000000000000000000000000
00000000000000000000000000000000000000000000000000000000000000000000000000000000000000000000000
00000000000000000000000000000000000000000000000000000000000000000000000000000000000000000000000
00000000000000000000000000000000000000000000000000000000000000000000000000000000000000000000000
00000000000000000000000000000000000000000000000000000000000000000000000000000000000000000000000
00000000000000000000000000000000000000000000000000000000000000000000000000000000000000000000000
00000000000000000000000000000000000000000000000000000000000000000000000000000000000000000000000
00000000000000000000000000000000000000000000000000000000000000000000000000000000000000000000000
00000000000000000000000000000000000000000000000000000000000000000000000000000000000000000000000
00000000000000000000000000000000000000000000000000000000000000455555555555555556000000000000000
00000000000000000000000000000000000000000000000000000000000000000000000000000000000000000000000
00000000000000000000000000000000000000000000000000000000000000000000000000000000000000000000000
00000000000000000000000000000000000000000000000000000000000000000000000000000000000000000000000
00000000000000000000000000000000000000000004555555555555555560000000000000000000000000000000000
00000000000000000000000000000000000000000000000000000000000000000000000000000000000000000000000
00000000000000000000000000000000000000000000000000000000000000000000000000000000000000000000000
00000000000000000000000000000000000000000000000000000000000000000000000000000000000000000000000
00000000000000000000000455555555555555556000000000000000000000000000000000000000000000000000000
00000000000000000000000000000000000000000000000000000000000000000000000000000333000000000000000
00000000000455555555560000000000000000000000000000000000000000000000000030033333300000000000000
00000000000000000000000000000000000000000000000000000000000000000000003330330033300000000000000
00000000000000000000000000000000000000000000000000000000000000000000033333333000330000000000000
00000000000000000000000000000000000000000000000000000000000000000000033333333330330000000000000
00000000000000000000000000000000000000000000000000000000011110000033333333333333333000000000000
11111111111100000000000000000000000011111111110000000000122221111133333111113333111110000000111
22222222222210000000000000000000001122222222221111000001222222223333332222233332222220000000222
22222222222221100000000000000001112222222222222222110012222222223322222222332222222220000000222
22222222222222211100000000001112222222222222222222221122222222222222222222222222222220000000222
22222222222222222211100000012222222222222222222222222222222222222222222222222222222220000000222
22222222222222222222211111122222222222222222222222222222222222222222222222222222222220000000222
22222222222222222222222222222222222222222222222222222222222222222222222222222222222220000000222
22222222222222222222222222222222222222222222222222222222222222222222222222222222222220000000222
22222222222222222222222222222222222222222222222222222222222222222222222222222222222220000000222
22222222222222222222222222222222222222222222222222222222222222222222222222222222222220000000222
22222222222222222222222222222222222222222222222222222222222222222222222222222222222220000000222
22222222222222222222222222222222222222222222222222222222222222222222222222222222222220000000222
22222222222222222222222222222222222222222222222222222222222222222222222222222222222220000000222
22222222222222222222222222222222222222222222222222222222222222222222222222222222222227777777222