00000000000000000000000000000000000000000000000000000000
00000000000000000000000000000000000000000000000000000000
00000000000000000000000000000000000000000000000000000000
00000000000000000000000000000000000000000000000000000000
00000000000000000000000000000000000000000000000000000000
00000000000000000000000000000000000000000000000000000000
00000000000000000000000000000000000000000000000000000000
00000000000000000000000000000000000000000000000000000000
00000000000000000000000000000000000000000000000000000000
00000000000000000000000000000000000000000000000000000000
00000000000000000000000000000000000000000000000000000000
00000000000000000000000000000000000000000000000000000000
00000000000000000000000000000000000000000000000000000000
00000000000000000000000000000000000000000000000000000000
00000000000000000000000000000000000000000000000000000000
00000000000000000000000000045555600000000000000000000000
00000000000000000000000000000000000000000000000000000000
00000000000000000000000000000000000000455560000000000000
00000000000000000000000000000000000000000000000000000000
00000000000000455555560000000000000000000000000003000000
00000000000000000000000000000000000000000000000003300000
00000000000000000000000000000000000000000000000033333000
00000000000000000000000000000000000000000000003333333300
11111111111111111111111111111111111111111111111111111111
22222222222222222222222222222222222222222222222222222222
22222222222222222222222222222222222222222222222222222222
22222222222222222222222222222222222222222222222222222222
22222222222222222222222222222222222222222222222222222222
22222222222222222222222222222222222222222222222222222222
22222222222222222222222222222222222222222222222222222222
22222222222222222222222222222222222222222222222222222222