00000000000000000000000000000000000000000000000000000000000000000000000000000000000000000000000
00000000000000000000000000000000000000000000000000000000000000000000000000000000000000000000000
00000000000000000000000000000000000000000000000000000000000000000000000000000000000000000000000
00000000000000000000000000000000000000000000000000000000000000000000000000000000000000000000000
00000000000000000000000000000000000000000000000000000000000000000000000000000000000000000000000
00000000000000000000000000000000000000000000000000000000000000000000000000000000000000000000000
00000000000000000000000000000000000000000000000000000000000000000000000000000000000000000000000
00000000000000000000000000000000000000000000000000000000000000000000000000000000000000000000000
00000000000000000000000000000000000000000000000000000000000000000000000000000000000000000000000
00000000000000000000000000000000000000000000000000000000000000000000000000000000000000000000000
00000000000000000000000000000000000000000000000000000000000000000000000000000000000000000000000
00000000000000000000000000000000000000000000000000000000000000000000000000000000000000000000000
00000000000000000000000000000000000000000000000000000000000000000000000000000000000000000000000
00000000000000000000000000000000000000000000000000000000000000000000000000000000000000000000000
00000000000000000000000000000000000000000000000000000000000000000000000000000000000000000000000
00000000000000000000000000000000000000000000000000000000000000000000000000000000000000000000000
00000000000000000000000000000000000000000000000000000000000000000000000000000000000000000000000
00000000000000000000000000000000000000000000000000000000000000000000000000000000000000000000000
00000000000000000000000000000000000000000000000000000000000000000000000000000000000000000000000
00000000000000000000000000000000000000000000000000000000000000000000000000000000000000000000000
00000000000000000000000000000000000000000000000000000000000000000000000000000000000000000000000
00000000000000000000000000000000000000000000000000000000000000000000000000000000000000000000000
00000000000000000000000000000000000000000000000000000000000000000000000000000000000000000000000
00000000000000000000000000000000000000000000000000000000000000000000000000000000000000000000000
00000000000000000000000000000000000000000000000000000000000000000000000000000000000000000000000
00000000000000000000000000000000000000000000000000000000000000000000000000000000000000000000000
00000000000000000000000000000000000000000000000000000000000000000000000000000000000000000000000
00000000000000000000000000000000000000000000000000000000000000000000000000000000000000000000000
00000000000000000000000000000000000000000000000000000000000000000000000000000000000000000000000
00000000000000000000000000000000000000000000000000000000000000000000000000000000000000000000000
00000000000000000000000000000000000000000000000000000000000000000000000000000000000000000000000
00000000000000000000000000000000000000000000000000000000000000000000000000000000000000000000000
00000000000000000000000000000000000000000000000000000000000000000000000000000000000000000000000
00000000000000000000000000000000000000000000000000000000000000000000000000000000000000000000000
00000000000000000000000000000000000000000000000000000000000000000000000000000000000000000000000
00000000000000000000000455555555555555556000000000000000000000000000000000000000000000000000000
00000000000000000000000000000000000000000000000000000000000000000000000000000000000000000000000
00000000000455555555560000000000000000000000000000000000000000000000000033000000000000000000000
00000000000000000000000000000000000000000000000000000000000000000000003333330000000000000000000
00000000000000000000000000000000000000000000000000000000000000000000033333333000000000000000000
00000000000000000000000000000000000000000000000000000000000000000033333333333330000000000000000
00000000000000000000000000000000000000000000000000000000000000033333333333333333333000000000000
11111111111111111111111111111111111111111111111111111111111111111111111111111111111110000000111
22222222222222222222222222222222222222222222222222222222222222222222222222222222222220000000222
22222222222222222222222222222222222222222222222222222222222222222222222222222222222220000000222
22222222222222222222222222222222222222222222222222222222222222222222222222222222222220000000222
22222222222222222222222222222222222222222222222222222222222222222222222222222222222220000000222
22222222222222222222222222222222222222222222222222222222222222222222222222222222222220000000222
22222222222222222222222222222222222222222222222222222222222222222222222222222222222220000000222
22222222222222222222222222222222222222222222222222222222222222222222222222222222222220000000222
22222222222222222222222222222222222222222222222222222222222222222222222222222222222220000000222
22222222222222222222222222222222222222222222222222222222222222222222222222222222222220000000222
22222222222222222222222222222222222222222222222222222222222222222222222222222222222220000000222
22222222222222222222222222222222222222222222222222222222222222222222222222222222222220000000222
22222222222222222222222222222222222222222222222222222222222222222222222222222222222220000000222
22222222222222222222222222222222222222222222222222222222222222222222222222222222222227777777222